behavioure->behaviour
blockign->blocking
ate->are
linve->live
actuallly->actually
asynchroniusly->asynchronously
synchroniusly->synchronously
seams->seems
selelction->selection
injectted->injected
prepanding->prepending
depanding->depending
undependant->independent
probablys->probably
ware->were
contetx->context
isseu->issue
issuw->issue
compatybility->compatibility
incompatybility->incompatibility
compatybilities->compatibilities
incompatybilities->incompatibilities
logn->long
postion->position
trase->trace
eider->either
isoaltion->isolation
symbolicl->symbolic
re enable->re-enable
foder->folder
fodername1->foldername1
fodler->folder
built in->built-in
tigether->together
auxyliary->auxiliary
squating->squatting
suppoter->supporter
routime->routine
explorere->explorer
mein->main
trigegred->triggered
windoe->window
hread->thread
tamplete->template
prising->praising
wi->we, will, 
dayly->daily
erdinal->ordinal
wizars->wizard
pined->pinned
inidcate->indicate
unsoecific->unspecific
soecific->specific
cpecific->specific
incomatible->incompatible
maliciouse->malicious
strickt->strict
brak->break
booth->both
vcertificate->certificate
fron->front
ahndling->handling
previwe->preview
variouse->various
resumeed->resumed
autoamtic->automatic
connencted->connected
querygin->querying
soem->some
previosue->previous
bfore->before
lettet->letter
readly->readily
wes->we
fluch->flush
crome->Chrome
chromim->Chromium
kmdutill->kmdutil
ancrypted->encrypted
hadrware->hardware
sandbocie->Sandboxie
sanboxie->Sandboxie
sandboxies->Sandboxie's, sandboxed, 
reparese->reparse
tailing->trailing
hoocked->hooked